11111111111111111111y
1###e####1####e####1y
11111111111111111111y
1#################11y
1#################11y
1#################11y
111##1###m###1##1111y
11##11#######11##111y
1##11#########11##11y
1p11###########11#f1y
111KKKKKKKKKKKKK1111y
