11111111111111111111y
11111111###111111111y
1111111##1##11111111y
111111##111##1111111y
11111##11111##111111y
1111##1111111##11111y
111##111111111##1111y
11##11111111111##111y
1##1111111111111##11y
1p111111111111111#f1y
11111111111111111111y
