#############y
1111111111111y
1###########1y
1###########1y
1p####c#####fy
111#e#1# e#11y
1111111111111y
