KKKKKKKKKKKKKKy
K############Ky
K####c#######Ky
K#p#1111##kk#Ky
K111k##ö##111Ky
K##11#f#c#111Ky
K#11#11#1#11#Ky
K#ö#####ö##ö#Ky
KKKKKKKKKKKKKKy