##############y
11111111111111y
1###########11y
11111111111111y
1p€€€€c€€€€€f1y
111€e€1€€e€111y
11111111111111y
